%%%%%%
%  %P%
% %G %
% %% %
%.   %
%%%%%%
